CHINESE japanese
MICHAEL	michael
ROBERT	robert
JOHN	john
JAMES	james
WILLIAM	william
BARBARA	barbara
SUSAN	susan
LISA	lisa
NANCY	nancy
RUTH	ruth
HELEN	helen
CAROL	carol
MARK	mark
FRANK	frank
ANDREW	andrew
JERRY	jerry
JOSHUA	joshua
REBECCA	rebecca
ANNA	anna
MINATO	minato
ANGELA	angela
THOMAS	thomas
CHARLES	charles
BRIAN	brian
DONNA	donna
ELLA	ella
LINDA	linda
MARY	mary
JOSEPH	joseph
CHRIS	chris
DAVID	david
RICHARD 	richard
JACK	jack
JOE	joe
ROY	roy
